2
2
..#####........#####..
.##xxx##......##...##.
##..c..##....##..o..##
#x.ccc..######.oo.ol.#
#xc.c.c.hhhhhh...l.o.#
#x.ccc..######.oool..#
##..c..##....##..o..##
.##xxx##......##...##.
..#####........#####..
