0
11
....c.b.
...#.ccc
..x#..c.
..x#o.o.
..B#....
c..#.#..
..o#+#Y.
.c.#.#x.
.c...#x.
.#.o.#..
c#..c.c.
.#.cy...
