6
14
..........
.########.
.#...####.
...#.##b#.
####.#..#.
####.#.##.
#ee.....#.
#e#.....#.
#e#.....#.
#e##B####.
#e#.....#.
#e#.o.x.#.
#e#.....#.
#e#######.
#ee#e.....
