4
2
#.......#
...o.o...
..##.##..
.o#ex.#o.
..#xxx#..
.o#ex.#o.
...x+x...
.o#ex.#o.
..#xxx#..
.o#ex.#o.
..##.##..
...o.o...
#.......#
