9
9
....Y.....
.oo##..#..
ool##xx#..
l..##xx...
.o.##xx#..
#g####.#..
.#........
..ol.o#o..
.y.o.oGo..
..#.......
