0
0
.....#...#.....
.o.o.#####.xxx.
..oo...#...x.x.
.ooro..Ro.oxxx.
.o.o...#...x.x.
...oo#####.xxx.
.....#...#.....
