0
0
......#xx#.
.o.o..#xx##
.#ooo.xxxx#
.#....xxxx#
.#.##o#xxx#
.o..#..xx##
.o..o..#...
...o.o.##o.
##...o#..o.
.#..o.o.o..
.##........
