4
4
######
#.xxx#
#..o.#
##oo.#
#....#
######
