0
11
.....#......
....#...o.o.
...#xo.ooo..
..#xxxo..oo.
.#xxx+xo....
#..x+x+xo.o.
...ox+xx+..#
.oo.oxx++x#.
.o..o.+xx#..
..ooo..x#...
.o.o...#....
......#.....
