7
7
...e#xxxxx#.#..
.o..#xxxxx#..#.
.#..#.....#.o..
....#.....#..#.
.o..###R###..#.
..o.......o....
..#.#..o...####
....o.o.o..o...
.o.#..#....#.o.
...#.....#.....
####o#...#o####
.o.o.#...#..e..
...o.#e..o..xxx
..o..#...#..xxx
r#...#...#..xxx
