4
2
#.......#
...o.o...
..##.##..
.o#ex.#o.
..#xxx#..
.o#.x.#o.
...x+x...
.o#.x.#o.
..#xxx#..
.o#.x.#o.
..##.##..
...o.o...
#.......#
