4
4
###e....##
...e......
.#xex##.x.
...e.e#.o.
#xoe.eo.o.
...e.e..#.
.ox.xeo##.
.xo.oexox.
....#e....
