8
5
.xx#...###...#xx.
xx.#.o.###.o.#.xx
x..#...###...#..x
#R###B#####Y###R#
#b###g#####y###g#
#G###Y#...#R###G#
#y###b#.o.#r###r#
#R###B#...#G###Y#
#g#r#r#.o.#b#b#y#
#Y#g#G.....B#y#B#
#.o.o.o...o.o.o.#
#...............#
