14
6
.#####...##....#.
##...#..##..oo.##
#..o.#..#...o.o.#
#.##x####....#..#
#..+xxxx+x#.##..#
#.oooooxxx.o.#o.#
#.oxxxxxx#.#.o.##
##########..o.##.
.........#....#..
