7
4
.#......#
.#..#...#
.#.o#.o##
.#.o..o.#
##...##.#
.o..#R.##
.ro...xxx
.oo###x+x
#..#.Bx+x
#..x+o#.#
#..+x.#..
##.+xo#b.
.#....#..
