15
6
.#####....##....#.
.#...##..##..oo.##
##..o.#..#...o.o.#
#..##x####....#..#
#...oxxxxxx#.##..#
#..ooo..xxx.o.#o.#
#.o.xxxxxx#.#.o.##
#.oo#######..o.##.
#...#.....#....#..
