10
3
#####....#####
#####lxx.#####
##lllx+o....##
ll+x+xlo......
lxxx##lo##.oo.
lxx##l...##o..
#l+x#lo..#...#
#lxxxlooo.o..#
##llx.o.....##
####..##..####
####..##..####
####..##..####
#####.o..#####
#####.oo.#####
#####....#####
######..######
