8
5
...#...###...#...
.x.#.x.###.x.#.x.
...#...###...#...
#R###B#####Y###R#
#b###g#####y###g#
#G###Y#...#R###G#
#y###b#.o.#r###r#
#R###B#.o.#G###Y#
#g#r#r#.o.#b#b#y#
#Y#g#G#.o.#B#y#B#
#...............#
#...............#
