10
3
#####....#####
#####lxx.#####
##lllx+o.l..##
ll+x+xlo......
lxxx##lo##.oo.
lxx##l...##o..
#l+x#lo..#...#
#lxxxlooolo..#
##llx.o.....##
####..##l.####
####..##..####
####..##..####
#####.o..#####
#####.oo.#####
#####....#####
######..######
