0
2
...####...
.o..##eoo.
.oo.ll.o..
#e..xx...#
##lxxxxl##
##lxxxxl##
#...xx..e#
..o.ll.oo.
.ooe##..o.
...####...
