5
0
....#..#.oooo..
.o..G..#..gogo.
.oc.#..#.o.o.o.
..###...#G.oo..
###.......#...#
.g.....o...G###
.......oo....##
####G#..o.##G##
..h..#....#.xxx
.o#.o..#....x+x
g.#..###..#.xxx
