0
7
.....he....
.#oo.h.....
.o...h.....
..o..h###x#
oco..h..xxx
..o.oh.#xxx
.oco.h..xxx
..o..h..x#x
.o.o.h##.##
.o..oh.....
o..#.h.....
.....he....
