8
8
.........e
.....o.o..
..oo###.o.
..#xxxx#..
.o#x+xx#o.
..#xx+##..
.o#xxxxo..
..##o##...
.o.o..o...
e.........
