8
8
..........
.....o.o..
..oo###.o.
..#xxxx#..
.o#x+xx#o.
..#xx+##..
.o#xxxxo..
..##o##...
.o.o..o...
..........
