0
0
......####......
.....oo..h..o...
..ho........h...
#..o..####..o..#
##...#xxxx#...##
.#..hxxxx..#..#.
.#.o#..xxxxh..#.
##o..#xxxx#...##
#...o.####...o.#
.oco.o......o...
..o.........oc..
......####......
