0
6
...#....#...#....#..
.o.o.o.o#....o....o.
..####..#+++######o.
..#xxxxxxx+xxxxxx#..
#o####+#########x#..
.o.o...o.o.....o..o.
.....#...#...#.....#
