11
9
.......#####..
......#.....#.
..####..o..o#.
##.....o.#..##
#..#.###c##..#
#.oooxxxx#.o.#
#..#xxxx#.o..#
.#.##xxxo..##.
.#...o#o..c.#.
..##.....c..#.
....########..
