7
7
....#.e...#####
.xc.#.c.c.#####
..c.#.....#####
....###.#######
##.####.####.e.
##.hhhh.h###.c.
##......h###.o.
###hhhh......c.
###h....h###...
###h.hhhh######
####.##########
##.e...########
##.c.c.########
##.....########
