3
12
##..####
....####
.xxxxxx.
.+xxxxx.
.#RRRR#.
.o.o....
#.o#.o.#
#...#.o#
##.o#o.#
##..o..#
.oo###.#
...o...#
#r...r##
