0
12
..olo..o.b#.xxx
.olollo..##o++x
..o.oo.#.#.o.+x
.l.#o.#..#..o..
.o.#..o..#.o.o.
..####B###.....
.o..#..#####.##
o.o.#.##.o...o.
..#.#.#.o.####.
G##.#.#.#.e#...
y#.o..#.#..Y..#
##..#l..#..####
....#..###....g
