7
6
xx..h..xx
x.o.h.o.x
.ooohoo..
....h..c.
hhhhhhhhh
....h....
.oo.h.c..
x.ooh.cox
xx..h..xx
