7
7
....#.e...#####
.xc.#.ccc.#####
..c.#.....#####
....###.#######
##.####.####.e.
##.hhhh.h###.o.
##......h###.c.
###hhhh......c.
###h....h###...
###h.hhhh######
####.##########
##.e...########
##.ccc.########
##.....########
