0
0
................
.cc.oh.o..h.c.o.
.xhhhhhchxhhhhh.
.xhxxhxxhhhxxhx.
.hh.o.o.o.h.hhh.
.c.c.ho..o..o.o.
................
