11
7
..#########....
.##...x...#####
.#...ox.#.....#
.#.o##+###.o..#
.#.lo.xolooo#.#
.#x+xxxxxxxx+x#
##.o.lxo#.o...#
#..##o+l#.#.###
#.o.o.x.#o.##..
#....oxo...#...
###...x...##...
..#########....
