7
8
...##........##...
..#xx#......#xx#..
.#xxxx#....#xxxx#.
.#xxxx#....#xxxx#.
#.oxx..#..#..xxo.#
#.oo.o.#..#.o.oo.#
#..o...#..#...o..#
##R##B##..##Y##G##
#.c..o..##....c..#
.#..o.c...o.co..#.
.#.c.oooroboo.o.#.
..#...oyogoc...#..
...##........##...
.....########.....
