5
0
#####...##
#####..o.#
#####.o.o.
#####.#.o.
######..o.
....#xx.#.
.oo#.xxx..
..o.o.xxx.
#..o.#.xx#
##......##
