5
1
....######....
.####....####.
.#....o.....#.
##.o.#o##o..##
#..###xxo.o..#
#.ooxxxxxx#o.#
#..#xxx+xx#..#
#..##oxx#o#..#
##..o.###.o.##
.#....o.o...#.
.####....####.
....######....
