5
11
xxx.#g##
xxx..R##
.x..#.##
#G###.##
.o.o....
..o.o...
.##h#...
.#r.#.##
.####.##
..o...##
.oco#..#
.......#
#####..#