8
6
e........
#####.##.
#.eee.##.
#......#.
##..o..#.
#..o.o.#.
#.....##.
#.e.#o.#.
#.e#...#.
#.e#.o##.
#..#xxx#.
#..#xxx#.
####.o##.
e........
