4
3
##...#..##
##.oo..o.#
##...oo.o.
###...#.o.
#######.o.
..#.xxx.#.
..o.xx#x#.
..o.ox#x..
#..o.xxxx#
##.....###
