12
8
.xx+xxx+xxxx.
x+o.o.o.o.oxx
x+.o.o.o.oo+x
x+.oo.oo.o.+x
+xo..o.oo.oxx
x+.oo..o...x+
+xoo.o.o.ooxx
xxo..oooo.o+x
.xx+xxx+xx+x.
