1
1
........
..c.c.c.
.oooooo.
.c.c.c..
........
h#h##h#h
h#h##h#h
.+x+x+x.
.x+x+x+.
.hhhhhh.
.oxoxox.
........
