6
2
##hh...#
..o..c.#
..o+x#.h
.c#xx#c.
h.#x+o..
#.c..o..
#...hh##
