6
6
...hh#......
.oohhh.oooo.
.o.hh#....o.
.o.#.#.##hhh
.o.#x+xx.hhh
....x++x##h#
#h##x+x+....
hhh.xx+x#.c.
hhh##.#.#c..
..c.c.#hh.c.
.c.c..hhhc..
......#hh...
