6
2
hhhh...h
..o..c.h
..o+x#..
.c#xx##.
h.#x+o..
h.c..o..
h...hhhh
