13
3
#####xxxxx####
####xxxxxx...#
#.o..#xx.#.o.#
#....##x##....
####....o.##B#
...#.oo.o.h..e
.ooo..#.###.o.
.o..oo...##.c.
...#.bo..##...
####...#######
