3
3
........
..#o.o..
.oe.x.#.
..xxx.o.
.o.xxx..
.#.x..o.
..o.o#..
........
