8
5
####################
#.o............xxxx#
#....o#lo.##o..x+x##
#####..o#oo.o..xxxx#
...#..o.o...o..#####
...#.......#####....
...#########........
