5
5
e..#####...
...#...#...
...#.o.#..e
####.#.####
#..o.x.o..#
#..#xxx##.#
#....x....#
####.o#####
...#.o.#e..
...#...#...
..e#####...
