5
5
xx.#...#.xx
x..Rx..#..x
...#.o.#...
###..go.#B#
..oooo...x.
..oyo..ro..
.xo...o..o.
#G#..bo.###
...#.o.#...
xr.RooxY..x
xx.#...#.xx
