4
0
###.......
#...l.#...
#.##+x#oo.
.loxxxxol.
.oo#x+##.#
...#.....#
.......###
